49
...##...#.#......#......#..#..........#####......
.#.#.#.#.#.###.#.#.#.#.#.###.###.#.#.#.###.#.#.#.
.#....##.#...###..#.#..#.#...###..#..........##.#
.###.#.#.#.#.#####.###.#.#####.#.#.#.#######.#.##
...#.....#.#.#......#..#.........#.........#..###
.#.#.###.#.#.#####.#.#.#.#####.#.###.#####.#.#.#.
...#....##.#....#..#.........#.....#.#...###.#..#
.#.#.#.#.###.#.#.#.###.###.#.#.#.###.#.#.#.#.#.#.
..#.#.#..##.....#....##....#...###......##...#..#
.#.#.#.#.#.###.#.#.#.#####.###.#.#.###.#.###.###.
............#...##.........#...#..#..###.........
.###.#.###.###.#.###.#####.#.###.###.#.##########
.#.#.....#....#...........#..#..#.##...#.#.......
.#.#.###.#.###.###.###.###.###.#.#.#.#.#.#.#.#.#.
...#......#.........#.....##.#.##.............#..
.#######.###.#####.###.###.#######.###.#.#.#.###.
.........#.........#......#............##...#....
##.#####.#.#.#.#.#.#.###.###.#.#.#.#####.#######.
.#..###..##...#...#..##...........###.......#....
.#.#.#.#####.#.###.#.#.#.#.#.#.###.#.#####.#.#.#.
#.............###.#.......#...#.....#.##....#.#..
.#.#.#.###.#.###.#.#.#.#.#.#.#.#.###.#.#.#.###.#.
....#....##..........##....#..#.#.....#.#........
.#.#.#.#.#.#.###.###.#.#.#####.#.#.#####.#.###.#.
###....####.#..#....#.....##....##...#....#.....#
.#.###.#.#.###.#.###.#.#.#.#.#.#.###.#.#####.#.##
.......#........#.......#...#...#..#......#.#....
.#####.#.###.#.#.#######.#.#.#.#.#.#.#####.#.#.#.
...........................#.##.#..###........#..
.###.###.###.#.#.###.###.#.#.###.#.#.#.#.###.#.#.
.....#..#.....#.#.....###.#.....#...#.#..#.......
.#.#.###.#.#.#.#.###.#.#####.###.#.#.#.#.#.#.####
...#...#.#.#...........##.##......##.#....#.#....
.#.#.#.#.#.#.###.#.#.#.###.#.#.#.###.#.#.#.###.#.
..##...#....#..##.#.....#.....#......##..####...#
.#####.#.#.#.#.###.#.#.#####.#.#.###.#.###.#.####
..##........####..#.##.#..#.#......#.#..#........
.#.#.###.#.#.#.#.#.#.###.###.#.###.#.###.#.#.#.#.
..............#.........#..##..#.....#.....#.##..
.#.###.#.###.#.#.###.#.###.#.#.#.#.#.###.#.#.#.##
.##...................##.#..#..#.####....#.....#.
.###.#.###.#.###.#.###.#.#.#.#.###.#.#.###.#.#.#.
.....#....#.......##.#.....#..##..........#......
.###.#.#.#####.#.#.#.#.#.#.#.#.#####.###.#.#.###.
#......#.......#....#..#.#....##.....#.##.#......
####.#########.#.###.#.#.#.#...#.#####.#.#.#.#.#.
.###.#......#..#.....#....###....#.#...........#.
.#.#.###.#.#.#####.#.###.###.#.#.#.#.###.#.#.#.#.
.#........#.......#.......###..##..##........#...
