10
..........
.########.
.#.#..#.#.
.#..#...#.
.#...##.#.
.#.#..#...
.#..#..##.
.##..#..#.
.###.##.##
......#...
