10
.........#
.#######.#
.#...#...#
.#.#.#.#.#
.#.#.#.#.#
.#.#.#.#.#
.#.#.#.#.#
.#.#.#.#.#
.#.#.#.#.#
...#...#..
