10
........##
.#......##
.#.#######
..........
..#.......
..#..#####
..#.......
..#..#..#.
..#..#..#.
..#..#..#.
