10
..........
.#.######.
.#....#.#.
.#..#...#.
.#...##.#.
.#.#..#...
.#..#..##.
.##..#..#.
.###.##.##
......#...
