50
..................................................
#################################################.
..................................................
.#################################################
..................................................
#################################################.
..................................................
.#################################################
..................................................
#################################################.
..................................................
.#################################################
..................................................
#################################################.
..................................................
.#################################################
..................................................
#################################################.
..................................................
.#################################################
..................................................
#################################################.
..................................................
.#################################################
..................................................
#################################################.
..................................................
.#################################################
..................................................
#################################################.
..................................................
.#################################################
..................................................
#################################################.
..................................................
.#################################################
..................................................
#################################################.
..................................................
.#################################################
..................................................
#################################################.
..................................................
.#################################################
..................................................
#################################################.
..................................................
.#################################################
..................................................
#################################################.

