10
..........
.########.
.#........
.#.#######
.#........
.########.
..........
.#########
..........
#########.
