10
..........
.#.######.
.#.#..#.#.
.#..#...#.
.##..##.#.
.#.#..#...
.#..#..##.
.##..#..#.
.###.##.##
......#...
