21
.#...#...#...#.......
.#.#.#.#.#.#.#.###.##
...........#...#.....
####.###.#.#.#.#.###.
.........#.#.....#...
.#######.#.#.###.#.#.
.#.......#.#.....#.#.
.#.#.#.#.#.#.###.#.#.
.#.#.#.#.#.......#.#.
.#.#.#.#.#.#.###.#.#.
...........#.........
##########.##########
.....................
.###################.
.....................
##########.##########
.....................
.#.###.#.###.#.#.###.
.#.............#.....
.#.#.#.#.#.#.#.#.#.##
...#.#...#...#...#...

