11
...........
.#.#.#.#.#.
...........
.#.#.#.#.#.
...........
.#.#.#.#.#.
...........
.###.#.#.#.
.........#.
.#.#.#.#.#.
...........

