20
....................
###################.
....................
.###################
....................
###################.
....................
.###################
....................
###################.
....................
.###################
....................
###################.
....................
.###################
....................
###################.
....................
.##################.
